11111111111111111111111111
1E0000000000000C00000C0001
10100101001000001010010001
10100100101010100010010001
1P0000000C00C0000000000001
10100100101010000010010001
10100100101010100000010001
10100100101C10100001110001
10C00100C0000000000001C0C1
11111111111111111111111111