11111111111111111111111111
10000C000000000C00000C00C1
1C00000000000000C000000001
1C000000000000000000000001
10000C000C0000000000000001
10000000000000000000000001
100C00000000000000000000C1
10C000000000000000000000E1
10000C00000000C0000000C0P1
11111111111111111111111111