11111111111111111111111111111
1E0000000000000C0000000C00001
10100101001000001010010000011
1P0000000C00C0000000000000001
10100100101010000010010000001
10100100101010100000010000001
10100100101C10100001110000001
10C00100C000000000000001C00C1
10000111000000000000000000011
10000100000000010010000000001
111000000011110011100000C0001
111000000011000000C0000000001
1110000000C0000000000C0111001
11111111111111111111111111111