11111111111111111111111111111
1E0000000000000C00000C0010001
1010C101001000001010010010101
10100100101010100010C10010111
1P0000000C00C01000100000000C1
11111111111111111111111111111