111111111111
100100C0000C
100001111100
1P0011E00000
111111111111